1 9 31
###############################
#p     *x*  12*   *  * * *    #
# # # #*# # #*#*# # # #*#*#*# #
#   *b     **  *  1   *   * * #
# # ## # #*# # #*#*# # # # #  #
#f          s**  *  *   1     #
# # # # # # # # # #*# #*# # # #
#*  *      *  *      *      2 #
###############################