2 9 31
###############################
# 1   ** *  1*   *  * * *     #
# # # #*# # #*#*# # # #*#*#*# #
#   *b**   **  *  1   *   * * #
# #1#*# # #*# # *#*#*# # # #* #
#        * s**  *f  *   1     #
# # #*# # # # # #2#*# #*# # # #
#*  *p      *f  *      *     x#
###############################